F 76,76,76

NO ./assets/arrowup.xpm
SO ./assets/arrowdown.xpm
WE ./assets/arrowright.xpm
EA               ./assets/arrowleft.xpm                      
C 255,255,25    





1111111111111111111
11111111111111111111
10W1001001001000001
1011000001000001001   111
1001001001111101111  101
1001111000010010011  11
1000000000000001001                 
1001111111111001001
1111000000000001011
1000000001000000001
1111111111111111111









