NO ./assets/n.xpm
SO ./assets/s.xpm
WE ./assets/w.xpm
EA ./assets/e.xpm
F 220,100,0
C 225,30,0
111111111111111111111111111111111111111111111111111111111111111111111111111111111111111111111111111111111111111111111111111111111111111111111111111
100000000000000000000000000000000000000000000000000000000000000000000000000000000000000000000000000000000000000000000000000000000000000000000000001
100000000000000000000111111111111111111111011111111111111111111111111111111111111111111111111111111111111111111111111111111111111111111111111111111
1000000000000000000000001                101
10000000000000000000000000000000000000000001
10000000000S00000000101111111111111111111111
10000000000000000000000000001
10000000000000000000000000001
11000000000000000000000000001
10000000000000000000000000001
10000000000000000000000000001
1100000111000001110000000000111
10000111 1000001 100000000001
11111111 1111111 111111111111