F 91,174,0
C 91,182,248

NO ./assets/pikachu.xpm
SO ./assets/mew.xpm
WE ./assets/evolixpikachu.xpm
EA ./assets/pichu.xpm

1111111111111111111
1001001001001001001
1001001001001001001
1001001001001001001
1001001000001001001
1000000000000000001
1000000000010000001
100000000S000000001
1000011111111000001
1111000000000001111
1000000101010000001
1111111111111111111
